2222222222
2        2
2        2
2        2
2       12
21111    2
2       42
2  4   552
2   4    2
2222222222