5555555555
5        5
5        5
57777    5
5   7    5
5   7    5
5   7    5
5        5
56666    5
5555555555